**************************************************
*       **          *                    *       *
* ***** ***** ***** ******************** * *******
*     *     * *               *                 S*
***** * ***** ********* ******* ******************
*     * *     *     *           * ****           *
* ***** ***** * *************** *        ******* *
* *                *            **************** *
* ****************** **********                  *
*       *          *          ********************
**** **** * *** *************                    *
*         *   * **          ******************** *
*** ********* **** ******** *******            * *
*   *       *      **       **    ************** *
*** * ***** * **************** ** **      ****** *
*     *   * * **          *    **    ****    *** *
********* * **** ******** * ************* **** * *
*         *      ***    *               * *    * *
* ***** ******** *** ****************** *** **** *
* *   *      ***             *        * *      * *
*   *** **** ***************** ***    * ** *** * *
***** ****   *     *             * ** * *    * * *
*   * *    *** *** * *********** ****** ****** * *
*** * ****       * *       ***** *      *      * *
*F  *  ********* * ******* *   * * ****** ****** *
*** **       ***** ******* *** * *             * *
* * *  *****             * *   * * ************* *
* * * ** ***************** *** *    ****         *
* * * ** ***             * *   ******* * *********
*        *** ***** ***** * * ********* * *   * * *
****** *****     *     * * *   *       * * * * * *
*      ** ****** ***** * * *** * ***** * * * * * *
* ******* ****** *     *   *   *   *   * * * * * *
*     *    *     * ***** * * ***** * ***         *
***** * **** ***** *     * *       * ******* *****
*   *     ** * *** * ************* * *******     *
* * ***** ** *     *         *     *             *
* ***  **  * ******************** ************** *
*       ** * * ** ***       ** **  *      ****** *
* ** ** ** *       ** *****    *** ******      * *
* *  **    ******* *      ****   *      * ****** *
* *   ****       * * ****  ********* ** * *      *
* **************** * **** ****     * **** * ******
*                *      *    * ***** *    * **   *
********** ************ *** ** *     * ** * ** * *
*    *** *     *     ** * * *  *** *** **** ** * *
* **     * ***   ***  * *   *      *      *    * *
* ***** ** ************ ********** * **** ****** *
*    **                 *               *      * *
**************************************************